{
	"levelID": 3,
	"rows": 12,
	"columns": 12,
	"data":
	[
		[ 0, 0, 0, 0, 0, 0, 0, 0, 0, 0, 0, 0],
		[ 0, 0, 0, 1, 1, 1, 1, 1, 1, 0, 0, 0],
		[ 0, 0, 1, 1, 1, 1, 1, 1, 1, 1, 0, 0],
		[ 0, 0, 1, 1, 0, 0, 0, 0, 1, 1, 0, 0],
		[ 0, 0, 1, 1, 0, 0, 0, 0, 0, 0, 0, 0],
		[ 0, 0, 1, 1, 0, 0, 0, 0, 0, 0, 0, 0],
		[ 0, 0, 1, 1, 0, 0, 0, 0, 0, 0, 0, 0],
		[ 0, 0, 1, 1, 0, 0, 0, 0, 0, 0, 0, 0],
		[ 0, 0, 1, 1, 0, 0, 0, 0, 1, 1, 0, 0],
		[ 0, 0, 1, 1, 1, 1, 1, 1, 1, 1, 0, 0],
		[ 0, 0, 0, 1, 1, 1, 1, 1, 1, 0, 0, 0],
		[ 0, 0, 0, 0, 0, 0, 0, 0, 0, 0, 0, 0]
	]
}
